DN_HistogramMode_5	DN_HistogramMode_5	distribution,location
DN_HistogramMode_10	DN_HistogramMode_10	distribution,location
CO_f1ecac	first_1e_ac	correlation,tau
CO_FirstMin_ac	first_min_acf	correlation,tau
CO_HistogramAMI_even_2.ami5	CO_HistogramAMI_even_2_5	information,correlation,AMI
CO_trev_1.num	CO_trev_1_num	correlation,nonlinear
MD_hrv_classic.pnn40	MD_hrv_classic_pnn40	medical
SB_BinaryStats_mean.longstretch1	SB_BinaryStats_mean_longstretch1	distribution,stationarity
SB_TransitionMatrix_3ac.sumdiagcov	SB_TransitionMatrix_3ac_sumdiagcov	symbolic,transitionmat
CO_Embed2_Dist_tau.d_expfit_meandiff	CO_Embed2_Dist_tau_d_expfit_meandiff	correlation,embedding
IN_AutoMutualInfoStats_40_gaussian.fmmi	IN_AutoMutualInfoStats_40_gaussian_fmmi	information,correlation,AMI
FC_LocalSimple_mean1.tauresrat	FC_LocalSimple_mean1_tauresrat	forecasting
DN_OutlierInclude_p_001.mdrmd	DN_OutlierInclude_p_001_mdrmd	distribution,outliers
DN_OutlierInclude_n_001.mdrmd	DN_OutlierInclude_n_001_mdrmd	distribution,outliers
SP_Summaries_welch_rect.area_5_1	SP_Summaries_welch_rect_area_5_1	FourierSpectrum
SB_BinaryStats_diff.longstretch0	SB_BinaryStats_diff_longstretch0	distribution,stationarity
SB_MotifThree_quantile.hh	SB_MotifThree_quantile_hh	symbolic,motifs
SB_MotifThree_quantile.hhh	SB_MotifThree_quantile_hhh	symbolic,motifs
SB_MotifThree_quantile.hhhh	SB_MotifThree_quantile_hhhh	symbolic,motifs
SC_FluctAnal_2_rsrangefit_50_1_logi.prop_r1	SC_FluctAnal_2_rsrangefit_50_1_logi_prop_r1	scaling
SC_FluctAnal_2_dfa_50_1_2_logi.prop_r1	SC_FluctAnal_2_dfa_50_1_2_logi_prop_r1	scaling
SP_Summaries_welch_rect.centroid	SP_Summaries_welch_rect_centroid	FourierSpectrum
